@@@@@@@@@@@@@@@@@@@@@@@@@@@@@@@@@@@@@@@@@@@@@@@@@@@@@@@@@@@@@@@@@@@@@@@@@@@@@@@@@@@@@@@@@@@@@@@@@@@@@@@@@
@@@@@@@@@@@@@@@@@@@@@@@@@@@@@@@@@@@@@@@@@@@@@@@@@@@@@@@@@@@@@@@@@@@@@@@@@@@@@@@@@@@@@@@@@@@@@@@@@@@@@@@@@
@@@@@@@@@@@@@@@@@@@@@@@@@@@@@@@@@@@@@@@@@@@@@@@@@@@@@@@@@@@@@@@@@@@@@@@@@@@@@@@@@@@@@@@@@@@@@@@@@@@@@@@@@
@@@@@@@@@@@@@@@@@@@@@@@@@@@@@@@@@@@@@@@@@@@@@@@@@@@@@@@@@@@@@@@@@@@@@@@@@@@@@@@@@@@@@@@@@@@@@@@@@@@@@@@@@
@@@@@@@@@@@@@...###.....###########....##...#####...####....######..######.....##......####@@@@@@@@@@@@@@
@@@@@@@@@@@@@..##...###..#.#.####...#.#####......#######....####.....###....######....###.#@@@@@@@@@@@@@@
@@@@@@@@@@@@@.##..##.####...#.####...#...##..####.....####.#...#...####....####...######...@@@@@@@@@@@@@@
@@@@@@@@@@@@@##########.....###.#####.....#####..####...#####..######...######.#####..###..@@@@@@@@@@@@@@
@@@@@@@@@@@@@###..###..##....###....######.....####.....###....##..#.#..##....###.....#####@@@@@@@@@@@@@@
@@@@@@@@@@@@@..#..#....#....#.##....#.###......###...#.#...#...###....#.....#####...###....@@@@@@@@@@@@@@
@@@@@@@@@@@@@...###.....###########....##...#####...####....#####...######.....##......####@@@@@@@@@@@@@@
@@@@@@@@@@@@@..##.#.####...#.####...#.#####......#######....####.....###....######....###.#@@@@@@@@@@@@@@
@@@@@@@@@@@@@.##..##....###..........#.####..####.....####.#...#...####....####...######...@@@@@@@@@@@@@@
@@@@@@@@@@@@@##########.....###...###.....###.....###...#####..######...######.#####..###..@@@@@@@@@@@@@@
@@@@@@@@@@@@@###..###..##....###....######.....####.....###....##..#.#..##....###.....#####@@@@@@@@@@@@@@
@@@@@@@@@@@@@..#..#....#....#.##....#.###......###...#.#...#...###....#.....###.#...###....@@@@@@@@@@@@@@
@@@@@@@@@@@@@...###.....###########....##...#####...####....######..######.....##......####@@@@@@@@@@@@@@
@@@@@@@@@@@@@..##.#.####...#.####...#.#####......#######....####.....###....######....###.#@@@@@@@@@@@@@@
@@@@@@@@@@@@@.##..##.####...#.####...#.####..####.....####.#...#.....##....####...######...@@@@@@@@@@@@@@
@@@@@@@@@@@@@##########.....###.#####.....#......####...#####..####.....######.#####..###..@@@@@@@@@@@@@@
@@@@@@@@@@@@@###..###..##....###....######.....####.....###....##..#.#..##....###.....#####@@@@@@@@@@@@@@
@@@@@@@@@@@@@..#..#....#....#.##....#.###......###...#.#...#...###....#.....#####...###....@@@@@@@@@@@@@@
@@@@@@@@@@@@@###..###..##...........######.....####.....###....##..#.#..##....###.....#####@@@@@@@@@@@@@@
@@@@@@@@@@@@@..#..#....#............#.###......###...#.#...#...###....#.....#####...###....@@@@@@@@@@@@@@
@@@@@@@@@@@@@...###.....###########....##...#####...####....######..######.....##......####@@@@@@@@@@@@@@
@@@@@@@@@@@@@..##.#.####...#.####...#.#####......#######....####.....###....######....###.#@@@@@@@@@@@@@@
@@@@@@@@@@@@@.##..##.####...#.####...#.####..####.....####.#...#...####....####...######...@@@@@@@@@@@@@@
@@@@@@@@@@@@@##########.....###.#####.....#####..####...#####..######...######.#####..###..@@@@@@@@@@@@@@
@@@@@@@@@@@@@###.#.....##....###....######.....####.....###....##..#.#..##....###.....#####@@@@@@@@@@@@@@
@@@@@@@@@@@@@..#.#....#....#.##....#.###......###...#.#...#...###....#.....#####...###..#..@@@@@@@@@@@@@@
@@@@@@@@@@@@@##########.....###.#####.....#####..####...#####..######...######.#####..###..@@@@@@@@@@@@@@
@@@@@@@@@@@@@##.#..#....##....###....######.....####.....###....##..#.#..##....###.....####@@@@@@@@@@@@@@
@@@@@@@@@@@@@..#..#....#....#.##....#.###......###...#.#...#...###....#.....#####...###....@@@@@@@@@@@@@@
@@@@@@@@@@@@@##########.....###.#####.....#####..####...#####..######...######.#####..###..@@@@@@@@@@@@@@
@@@@@@@@@@@@@##.#.#....##....###....######.....####.....###....##..#.#..##....###.....#####@@@@@@@@@@@@@@
@@@@@@@@@@@@@..#..#....#....#.##.....###.....###...#.#.....#...###....#.....#####...###....@@@@@@@@@@@@@@
@@@@@@@@@@@@@##########....#####..####...##.#.#####..##...#..#...###....#.####.#####..###..@@@@@@@@@@@@@@
@@@@@@@@@@@@@###..#..#...###....#...#.#...##.....######.....###..###.#..##....###.....#####@@@@@@@@@@@@@@
@@@@@@@@@@@@@..#..#.##...#..#.##....#.##..####...#..#.#...#...#....#.###...#.#......###....@@@@@@@@@@@@@@
@@@@@@@@@@@@@##########.....###.#####..#..#####...###....#...###....###..##...######..###..@@@@@@@@@@@@@@
@@@@@@@@@@@@@###..#....##....######...#.#.......####.....###...#.#...#..##....###.....#####@@@@@@@@@@@@@@
@@@@@@@@@@@@@..#..######..####...##.#...###....##...###....#...###....#.....#####...###....@@@@@@@@@@@@@@
@@@@@@@@@@@@@..##.#.####...#.####...#.#####......#######....####.....###....######....###.#@@@@@@@@@@@@@@
@@@@@@@@@@@@@.##..##.####...#.####...#.####..####.....####.#...#.....##....####...######...@@@@@@@@@@@@@@
@@@@@@@@@@@@@##########.....###.#####.....#......####...#####..####.....######.#####..###..@@@@@@@@@@@@@@
@@@@@@@@@@@@@###..###..##....###....######.....####.....###....##..#.#..##....###.....#####@@@@@@@@@@@@@@
@@@@@@@@@@@@@##########.....###.#####.....#......####...#####..####.....######.#####..###..@@@@@@@@@@@@@@
@@@@@@@@@@@@@###..###..##....###....######.....####.....###....##..#.#..##....###.....#####@@@@@@@@@@@@@@
@@@@@@@@@@@@@..#..#....#....#.##....#.###......###...#.#...#...###....#.....#####...###....@@@@@@@@@@@@@@
@@@@@@@@@@@@@###..###..##...........######.....####.....###....##..#.#..##....###.....#####@@@@@@@@@@@@@@
@@@@@@@@@@@@@@@@@@@@@@@@@@@@@@@@@@@@@@@@@@@@@@@@@@@@@@@@@@@@@@@@@@@@@@@@@@@@@@@@@@@@@@@@@@@@@@@@@@@@@@@@@
@@@@@@@@@@@@@@@@@@@@@@@@@@@@@@@@@@@@@@@@@@@@@@@@@@@@@@@@@@@@@@@@@@@@@@@@@@@@@@@@@@@@@@@@@@@@@@@@@@@@@@@@@
@@@@@@@@@@@@@@@@@@@@@@@@@@@@@@@@@@@@@@@@@@@@@@@@@@@@@@@@@@@@@@@@@@@@@@@@@@@@@@@@@@@@@@@@@@@@@@@@@@@@@@@@@
@@@@@@@@@@@@@@@@@@@@@@@@@@@@@@@@@@@@@@@@@@@@@@@@@@@@@@@@@@@@@@@@@@@@@@@@@@@@@@@@@@@@@@@@@@@@@@@@@@@@@@@@@
@@@@@@@@@@@@@@@@@@@@@@@@@@@@@@@@@@@@@@@@@@@@@@@@@@@@@@@@@@@@@@@@@@@@@@@@@@@@@@@@@@@@@@@@@@@@@@@@@@@@@@@@@
