@@@@@@@@@@@@@@@@@@@@@@@@@@@@@@@@@@@@@@@@@@@@@@@@@@@@@@@@@@@@@@@@@@@@@@@@@@@@@@@@@@@@@@@@@@@@@@@@@@@@@@@@@
@@@@@@@@@@@@@@@@@@@@@@@@@@@@@@@@@@@@@@@@@@@@@@@@@@@@@@@@@@@@@@@@@@@@@@@@@@@@@@@@@@@@@@@@@@@@@@@@@@@@@@@@@
@@@@@@@@@@@@@@@@@@@@@@@@@@@@@@@@@@@@@@@@@@@@@@@@@@@@@@@@@@@@@@@@@@@@@@@@@@@@@@@@@@@@@@@@@@@@@@@@@@@@@@@@@
@@@@@@@@@@@@@@@@@@@@@@@@@@@@@@@@@@@@@@@@@@@@@@@@@@@@@@@@@@@@@@@@@@@@@@@@@@@@@@@@@@@@@@@@@@@@@@@@@@@@@@@@@
@@@@@@@@@@@@@...###.....###########....##...#####...####....######..######.....##......####@@@@@@@@@@@@@@
@@@@@@@@@@@@@..##...###..#.#.####...#.#####......#######....####.....###....######....###.#@@@@@@@@@@@@@@
@@@@@@@@@@@@@.##..##.####...#.####...#...##..####.....####.#...#...####....####...######...@@@@@@@@@@@@@@
@@@@@@@@@@@@@##########.....###.#####.....#####..####...#####..######...######.#####..###..@@@@@@@@@@@@@@
@@@@@@@@@@@@@###..###..##....###....######.....####.....###....##..#.#..##....###.....#####@@@@@@@@@@@@@@
@@@@@@@@@@@@@..#..#....#....#.##....#.###......###...#.#...#...###....#.....#####...###....@@@@@@@@@@@@@@
@@@@@@@@@@@@@...###.....###########....##...#####...####....#####...######.....##......####@@@@@@@@@@@@@@
@@@@@@@@@@@@@..##.#.####...#.####...#.#####......#######....####.....###....######....###.#@@@@@@@@@@@@@@
@@@@@@@@@@@@@.##..##....###..........#.####..####.....####.#...#...####....####...######...@@@@@@@@@@@@@@
@@@@@@@@@@@@@##########.....###...###.....###.....###...#####..######...######.#####..###..@@@@@@@@@@@@@@
@@@@@@@@@@@@@###..###..##....###....######.....####.....###....##..#.#..##....###.....#####@@@@@@@@@@@@@@
@@@@@@@@@@@@@..#..#....#....#.##....#.###......###...#.#...#...###....#.....###.#...###....@@@@@@@@@@@@@@
@@@@@@@@@@@@@...###.....###########....##...#####...####....######..######.....##......####@@@@@@@@@@@@@@
@@@@@@@@@@@@@..##.#.####...#.####...#.#####......#######....####.....###....######....###.#@@@@@@@@@@@@@@
@@@@@@@@@@@@@.##..##.####...#.####...#.####..####.....####.#...#.....##....####...######...@@@@@@@@@@@@@@
@@@@@@@@@@@@@##########.....###.#####.....#......####...#####..####.....######.#####..###..@@@@@@@@@@@@@@
@@@@@@@@@@@@@###..###..##....###....######.....####.....###....##..#.#..##....###.....#####@@@@@@@@@@@@@@
@@@@@@@@@@@@@..#..#....#....#.##....#.###......###...#.#...#...###....#.....#####...###....@@@@@@@@@@@@@@
@@@@@@@@@@@@@###..###..##...........######.....####.....###....##..#.#..##....###.....#####@@@@@@@@@@@@@@
@@@@@@@@@@@@@..#..#....#............#.###......###...#.#...#...###....#.....#####...###....@@@@@@@@@@@@@@
@@@@@@@@@@@@@...###.....###########....##...#####...####....######..######.....##......####@@@@@@@@@@@@@@
@@@@@@@@@@@@@..##.#.####...#.####...#.#####......#######....####.....###....######....###.#@@@@@@@@@@@@@@
@@@@@@@@@@@@@.##..##.####...#.####...#.####..####.....####.#...#...####....####...######...@@@@@@@@@@@@@@
@@@@@@@@@@@@@##########.....###.#####.....#####..####...#####..######...######.#####..###..@@@@@@@@@@@@@@
@@@@@@@@@@@@@###..#....##....###....######.....####.....###....##..#.#..##....###.....#####@@@@@@@@@@@@@@
@@@@@@@@@@@@@..#..#....#....#.##....#.###......###...#.#...#...###....#.....#####...###....@@@@@@@@@@@@@@
@@@@@@@@@@@@@@@@@@@@@@@@@@@@@@@@@@@@@@@@@@@@@@@@@@@@@@@@@@@@@@@@@@@@@@@@@@@@@@@@@@@@@@@@@@@@@@@@@@@@@@@@@
@@@@@@@@@@@@@@@@@@@@@@@@@@@@@@@@@@@@@@@@@@@@@@@@@@@@@@@@@@@@@@@@@@@@@@@@@@@@@@@@@@@@@@@@@@@@@@@@@@@@@@@@@
@@@@@@@@@@@@@@@@@@@@@@@@@@@@@@@@@@@@@@@@@@@@@@@@@@@@@@@@@@@@@@@@@@@@@@@@@@@@@@@@@@@@@@@@@@@@@@@@@@@@@@@@@
@@@@@@@@@@@@@@@@@@@@@@@@@@@@@@@@@@@@@@@@@@@@@@@@@@@@@@@@@@@@@@@@@@@@@@@@@@@@@@@@@@@@@@@@@@@@@@@@@@@@@@@@@
@@@@@@@@@@@@@@@@@@@@@@@@@@@@@@@@@@@@@@@@@@@@@@@@@@@@@@@@@@@@@@@@@@@@@@@@@@@@@@@@@@@@@@@@@@@@@@@@@@@@@@@@@
