...###.....###########....
..##.#.####...#.####...#.#
.##..##.####...#.####...#.
########################
########################
###..###..##....###....###
..#..#....#....#.##....#.#
.##.##.#.##.#.##....#.##..
.#......##.......##.....##
.#.....###..#.###..#..###.
.########..#..###..#..###.
.########..#..###..#..###.
.#......##.......##.....##
.#.....###..#.###..#..###.
##........#...#.####.....#
#......#..###...###....###
###..###..##....###....###