@@@@@@@@@@@@@@@@@@@@@@@@@@@@@@@@@@@@@@@@@@@@@@@@@@@@@@@@@@@@@@@@@@@@@@@@@@@@@@@@@@@@@@@@@@@@@@@@@@@@@@@@
@@@@@@@@@@@@@@@@@@@@@@@@@@@@@@@@@@@@@@@@@@@@@@@@@@@@@@@@@@@@@@@@@@@@@@@@@@@@@@@@@@@@@@@@@@@@@@@@@@@@@@@@
@@@@@@@@@@@@@@@@@@@@@@@@@@@@@@@@@@@@@@@@@@@@@@@@@@@@@@@@@@@@@@@@@@@@@@@@@@@@@@@@@@@@@@@@@@@@@@@@@@@@@@@@
@@@@@@@@@@@@@@@@@@@@@@@@@@@@@@@@@@@@@@@@@@@@@@@@@@@@@@@@@@@@@@@@@@@@@@@@@@@@@@@@@@@@@@@@@@@@@@@@@@@@@@@@
@@@@@@@@@@@@@...###.....###########....##...#####...####....######..######.....##......####@@@@@@@@@@@@@
@@@@@@@@@@@@@..##.#.####...#.####...#.#####......#######....####.....###....######....###.#@@@@@@@@@@@@@
@@@@@@@@@@@@@.##..##.####...#.####...#.####..####.....####.#...#...####....####...######...@@@@@@@@@@@@@
@@@@@@@@@@@@@##########.....###.#####.....#####..####...#####..######...######.#####..###..@@@@@@@@@@@@@
@@@@@@@@@@@@@###..###..##....###....######.....####.....###....##..#.#..##....###.....#####@@@@@@@@@@@@@
@@@@@@@@@@@@@..#..#....#....#.##....#.###......###...#.#...#...###....#.....#####...###....@@@@@@@@@@@@@
@@@@@@@@@@@@@...###.....###########....##...#####...####....######..######.....##......####@@@@@@@@@@@@@
@@@@@@@@@@@@@..##.#.####...#.####...#.#####......#######....####.....###....######....###.#@@@@@@@@@@@@@
@@@@@@@@@@@@@.##..##.####...#.####...#.####..####.....####.#...#...####....####...######...@@@@@@@@@@@@@
@@@@@@@@@@@@@##########.....###.#####.....#####..####...#####..######...######.#####..###..@@@@@@@@@@@@@
@@@@@@@@@@@@@###..###..##....###....######.....####.....###....##..#.#..##....###.....#####@@@@@@@@@@@@@
@@@@@@@@@@@@@..#..#....#....#.##....#.###......###...#.#...#...###....#.....#####...###....@@@@@@@@@@@@@
@@@@@@@@@@@@@...###.....###########....##...#####...####....######..######.....##......####@@@@@@@@@@@@@
@@@@@@@@@@@@@..##.#.####...#.####...#.#####......#######....####.....###....######....###.#@@@@@@@@@@@@@
@@@@@@@@@@@@@.##..##.####...#.####...#.####..####.....####.#...#...####....####...######...@@@@@@@@@@@@@
@@@@@@@@@@@@@##########.....###.#####.....#####..####...#####..######...######.#####..###..@@@@@@@@@@@@@
@@@@@@@@@@@@@###..###..##....###....######.....####.....###....##..#.#..##....###.....#####@@@@@@@@@@@@@
@@@@@@@@@@@@@..#..#....#....#.##....#.###......###...#.#...#...###....#.....#####...###....@@@@@@@@@@@@@
@@@@@@@@@@@@@###..###..##....###....######.....####.....###....##..#.#..##....###.....#####@@@@@@@@@@@@@
@@@@@@@@@@@@@..#..#....#....#.##....#.###......###...#.#...#...###....#.....#####...###....@@@@@@@@@@@@@
@@@@@@@@@@@@@...###.....###########....##...#####...####....######..######.....##......####@@@@@@@@@@@@@
@@@@@@@@@@@@@..##.#.####...#.####...#.#####......#######....####.....###....######....###.#@@@@@@@@@@@@@
@@@@@@@@@@@@@.##..##.####...#.####...#.####..####.....####.#...#...####....####...######...@@@@@@@@@@@@@
@@@@@@@@@@@@@##########.....###.#####.....#####..####...#####..######...######.#####..###..@@@@@@@@@@@@@
@@@@@@@@@@@@@###..###..##....###....######.....####.....###....##..#.#..##....###.....#####@@@@@@@@@@@@@
@@@@@@@@@@@@@..#..#....#....#.##....#.###......###...#.#...#...###....#.....#####...###....@@@@@@@@@@@@@
@@@@@@@@@@@@@@@@@@@@@@@@@@@@@@@@@@@@@@@@@@@@@@@@@@@@@@@@@@@@@@@@@@@@@@@@@@@@@@@@@@@@@@@@@@@@@@@@@@@@@@@@
@@@@@@@@@@@@@@@@@@@@@@@@@@@@@@@@@@@@@@@@@@@@@@@@@@@@@@@@@@@@@@@@@@@@@@@@@@@@@@@@@@@@@@@@@@@@@@@@@@@@@@@@
@@@@@@@@@@@@@@@@@@@@@@@@@@@@@@@@@@@@@@@@@@@@@@@@@@@@@@@@@@@@@@@@@@@@@@@@@@@@@@@@@@@@@@@@@@@@@@@@@@@@@@@@
@@@@@@@@@@@@@@@@@@@@@@@@@@@@@@@@@@@@@@@@@@@@@@@@@@@@@@@@@@@@@@@@@@@@@@@@@@@@@@@@@@@@@@@@@@@@@@@@@@@@@@@@